333232232323233223223322323332
333323323232322332323323232333
223322222222224222232232222323
332222242222222222222222222222
332222222222222222222222222222
322322222222222422222222222222
322222222222222222222222222422
332222222222222222222222222222
233222222222222222422222222222
322222422222222222222222222222
232232222222222222222222222222
322222222222222222222222222222
232322222422222222222222222233
223222223223322322422222232331
333223232332233232323232323111
323332333223223223232323331111
