111111222222222222222222222222
111123222222222222222222242222
111222222222222222222222222222
111222224222222222222222222322
111322222222222224222222222222
112222222222222222222222222222
112222242222222222222222222222
112222222222222222222222242222
112232222222222222222222222222
112222222422222222222222222222
111232222222222222222242222222
111222222222242222222222222222
111122222322222222222223222222
111111122222222222222222222211
111111111111111111111111111111
111111111111111111111111111111

