222222222222222222222222222222
222232322222222222242222322222
223222222222222222222222222222
222222222222222222222222222322
222222242222222222222242222222
222222222222222222222222222222
222222222222222224222222222222
222222222222222222222222222222
223222222222222222222222222222
222222222222422222222222222222
222222222222222222222222422222
222232222222222222222222222321
222222242222222222222222222221
122222222222222222224222232211
112232222222222222222222222111
112222222222222222222222222111

