222222222222222222222211111111
222222322222222222222222211111
222222222222224222222322222111
222222222222222222223232222111
222222222222222222222322222211
222222222222222222222222222221
222222222222222222222222224221
222222224222222222222222223221
222222222222222222222222222221
222322222222222222222222222221
222222222222222222222222322211
122222222242222222422222222111
112222222222223222222222222111
111111222222222222222221111111
111111111111111111111111111111
111111111111111111111111111111

