112222222222222222222222222111
112222422223222242222222222111
111322222222222222222422223111
111122222222222222222222232111
111111112222222222222422221111
111111112222222222222222221111
111111122222222422222222232111
111122222222222222222222222211
111222222000000000000002222211
11222000a000000000000000a02211
1220000a0000000000000000000221
12000000000000000000000000a021
a00a00000000000000000f00000021
0a000000000f00000000000000000a
a0a000000000000000000000000aa0
0f0a00f000000000000000000aa00a
