323323323323111111111111111111
323432323232322111111111111111
232223232222223222222322222222
322232223223222232222222232222
22242223222223222222j222222222
223223222222222222222242222222
222222222242222222222222222222
222222222222222222222222222222
222222222222222222222222222222
222222222222222242222222222222
222222222222222222222222222222
232222222222322222222222422222
122322222222222222222222222222
112222222222222224222222222222
111122222222222222222222222222
111112222222222222222222222222
