a00a0a0a0a000a00aa00aa0a000aaa
a0aaa0aaa0aa0aaa00aa0aa0a0a0aa
00a00000a000a000a00000000a0a0a
aa00000f000000000f00000000000a
a0a000000000000000000000000aa0
a0a0000000000000000000f000000a
000a0000000f0000000000000000a0
0aa0000000000000000000000000a0
a000000f0000000000000000000a0a
a0a00000000000000000000000f0a0
a0a0000000000000000000f00000a0
a00a0000000000000000000000a00a
0a000000000f0000000000000000a0
aa00000000000000aa0000a00a0aa0
a0a00000aa00a00a00a00a0aa0a0aa
aaa000aa00aa0aa000aaaa00a000aa