0f0a00f000000000000000000aa00a
0aa000000000000000000000000a0a
a000000000f000000000000000000a
0a000f000f0f0000000000000000a0
00a000000000f000000000f000000a
0a00000f00f000f000000000000a0a
0aa00000f000f000000000000000a0
a00000000f0f00000000f00000000a
0a00000000f00000000000000000a0
a00000000000000000000000f0000a
aa00000000000000000000000000a0
afa0000000000000f000000000000a
0a0a00f000000000000000000a0111
0a00a0000000000000000a011111f0
aafa0a0000000000000a0111000aa0
00a0afa0000000000aa011100a0a0a