111111111111111111111111111111
111111111111111111111111111111
222222222111111111111111111111
222232222222222222221111111111
222222222224222232222221111111
222222222222222222222222221111
222222222222222222222224222211
222224222222222224222222222211
222222222222222222222222232211
222222222222222222222222222221
222222222222242222222222222222
222222222222222222222222222222
222222222222222222222242222222
223222222422222222222222222222
222222222222222222222222222222
222222222222222222222222222222
