111111111111111111111111111111
111111111111111111111111111111
111111111111111111111111111111
111111111122222222221111111111
111111122222222222222222221111
111111222220000a00022222222111
111112220000000000000000022111
11111220000af00000000000002211
11111220a000000000000f00022211
1111122000000000000000a0222211
1111112220000f0a00000002222111
111111112220000000000000aa2211
111111111222000000f000aaf0a021
111111111122200000000a0a0a0aa2
11111111112220000000a0a0afa00a
111111111122200000aa0a0aa0afaa