a0fa0aa0000000000aa011100aaaaa
aa00a0000000000000a0aa11000a0a
a00a000000000000000a0a01111aa0
0aaaaa00000f0000000000a000111a
000000a00000000000000000f00011
aaa00aa0000000000000f00000aa0a
a0aa00a000000000000000000a000a
a000a0a0000000f00000000h00a0aa
a00a00aa0000000000000000000a00
a0a0a00a0000f000000000000000a0
aa0aa000a0000000000002200000a0
0000000aa00000222222222000000a
aa0aaa0a00000022222222200000a0
a0a000a000000022000f000000000a
aa00a0a000000022000000000000a0
a0aa0a0aa00000220000000000a0aa