111111111111111112220f000a0000
1111111111111111111222220000a0
11111111111111111111111222f000
111111111111111111111111122222
111111111111111111111111111111
111111111111111111111111111111
111111111111111111111111111111
111111111111111111111111111111
111111111111111111111111111111
111111111111111111111111111111
222211111111111111111111111111
242222322111111111111111111111
222222222222222111111111111111
222222222222322221111111111111
222422222222222242221111111111
222222222222222222222211111111
