111111111111111111111111111111
111111111112222222222222222222
111111112222222222222222222222
111111122222222000000000000000
111111222220000000000000a00000
11111122220000f0000a000000f000
11111222200000000000a000000000
111112222000a000000f000a000000
11111222000a000000000000000000
1111122200000f00000000000000a0
111112220000000000000000000000
11111222220000000000f000000000
1111112222222200000000000000f0
111111122222222222222222222222
111111111122222222222222222222
111111111111111111111111111111
