111111111122200000aa0a0aa0a00a
22222211122220000000aa00a00a00
2222222222220000000a0aa00aa00a
000002222200a0000000a00a0a00a0
00000f000000000000000aa0aa0a0a
00000000000000000000000a00a0a0
000000000f00000a0000000a000a0a
00f000000000000000000000aaa0aa
00000000000af00000000000000000
000000000000000000a00000022222
0000000a00000000000000a0222211
0000000000000f0a00000022222111
0000f0000000000000222222111111
222222222222222222222211111111
222222222222222222221111111111
111111111111111111111111111111