00aa00a0a0a0000000000000000a0a
0aa000aa0a000000f00000000000a0
a00a0a00a00000000000000f00000a
0a00a0000a00000000000000000fa0
a0aa0fa0a000000000f00000000000
a0a00aaa0000000000000000000000
0a0aa0000f000000000000f0000000
a0a0f000000000000000000f0f0000
000000000000f0000f000000f00000
2200000000000000000000f0000000
122000000000000000f00000000000
1222000f00000f0000000000000222
112220000000000000222222222222
111222222222222222222222222222
111112222222222222222111111111
111111111111111111111111111111