00aa00a0a000002200000000000a0a
0aa000aa00a00022f000000a00a0a0
a00a0a00000a00220000000f0aa00a
0a00a0000a000a2200000000a00fa0
00aa0f000h00a02200f000000000aa
000000000000002200000000000a01
0000000000000022f000000h00a011
000000022000f02200000000000a1a
00000002200000220f000000f00a10
000f0f02200000220000022000a01a
00000002200a0022f0a002200a0110
2222000220a0002200000220af010a
2222200220000022000002222211af
222222222222222222222211111a0a
111122222222222222211112222f0a
1111111111111111111122220a0aa0