111111111111111111111111111111
111111115555555555555511111111
1111555555n55555555n5555555555
1115n5n55555555555555555555555
115555555555555555555555555511
115555555555555555555555555111
15n5555555555555555555555n5111
155555555555555555555555555111
1555555555555555555555555n5111
155555555555555555555555555111
115n55555555555555555555n55111
115555555555555555555555551111
1115n555555555555555555n511111
111155n55555555555n55555111111
111111555555555555555111111111
111111111111111111111111111111