111111111111111111111111111111
1111111111115n1111555555555111
55555n5555115515n555555n555111
555555555551111n55555555555511
11555555n551111555555555555551
155555555555n5555555555555nn51
155555555555555555555555555551
15n555555555555555555555555551
155555555555555555555555555n51
1n555555555555555555555n55n511
115n55555555555555555555555111
115555555555555555555511111111
111555555555555111111111111155
11115n5555551111115n11111155nn
111155555511111111n51111555n5n
11111555511111111111111155n55n