11111555511111111111111155nn5n
1111555555111111111111111155n5
1115n5555511111111111111111155
1155555555n5111111111111111111
1155555555555555n5551111111111
155555555555555555n55n55111111
n55555555555555555555555n51111
5n5555555555555555555555555n55
n55555555555555555555555555555
5nn555555555555555555555555555
n5n555555555555555555555555555
5n5nn55n5555555555555555555555
nn5n5n555555555555n55555555555
5nnn55nn5555nn555n5n55nn555555
nn55nn5n55nn55nn5n55nn5n555n5n
55n5n5n5nn55n555n55n55n5nnn5n5


