55n5nn555511111111111111111111
5n5551111111111111111111111111
551111111111111111111111111111
11111111111111111555555n551111
11111111155555555n5n5555555555
11115n55555555n555555n555n5555
115n55555555555555555555555555
555555555555555555555555555555
555555555555555555555555555555
555555555555555555555555555555
555555555555555555555555555555
55n555555555555555555555555555
5555555n5555555555555n55555555
555n555nn5555nn55555n55n555555
n5n5n5n55nn5n55n555n5nn5n5nn5n
nn5n5nn5n5nn55n5nnn5n55n5n55n5
