111111111111111o11111111111111
111111111555555nn5111111111111
11111n555555n55555555551111111
15555555n555555555555555551111
555n55555555555555555555n55511
555555555555555555555555555511
555555555555555555555555555551
55555555555555555555555555n5n1
5555555n5555555555555555555n51
55555555555555555n5555555nn55n
5555555555555555555555555n5n55
5555555555555555555n5n55n5n5nn
55555555555555555555n5n5555n55
555555n5555555n5n5nn555n5n55n5
n5n5nn5nn55n5n5n555n55n5n5nn55
5n5nn55n5nn5nn55nn555n5n555n55
